####################################-
################.###################-
################.###################-
################.###################-
################.###################-
################.###################-
################.###################-
################.###################-
################.###################-
################.###################-
################.###################-
################.###################-
################.###################-
################.###################-
################.###################-
################.###################-
################.###################-
################.###################-
################.###################-
################.###################-
################.###################-
################.###################-
################.###################-
################.###################-
################.###################-
################.###################-
################.###################-
################.###################-
################.###################-
################.###################-
################.###################-
################.###################-
################.###################-
################.###################-
################.###################-
################.###################-
################.###################-
################.###################-
################.###################-
################.###################-
################.###################-
################.###################-
################.###################-
################.###################-
################.###################-
################.###################-
################.###################-
################.###################-
################.###################-
################.###################-
################.###################-
################.###################-
################.###################-
################.###################-
################.###################-
################.###################-
################.###################-
################.###################-
################.###################-
###############...##################-
###############.I.##################-
###############...##################-
####################################-
####################################
