####################################-
####################################-
####################################-
####################################-
####################################-
####################################-
####################################-
####################################-
####################################-
####################################-
####################################-
####################################-
####################################-
####################################-
####################################-
####################################-
####################################-
####################################-
####################################-
####################################-
####################################-
####################################-
####################################-
####################################--
####################################-
####################################-
####################################-
####################################-
####################################-
####################################-
####################################-
####################################-
####################################-
####################################-
####################################-
####################################-
####################################-
####################################-
####################################-
##################.#################-
##############...#.#################-
##########.....O.#.#################-
##########.###...#.#################-
##########.#######.#################-
##########.####....#################-
##########.####.####################-
##########.####.####################-
##########.####.####################-
##########.####.####################-
##########.####.####################-
##########.####.####################-
##########.##.....##################-
##########.##..I..##################-
##########.##.....##################-
##########.##.###.##################-
##########.##.....##################-
##########.####.####################-
##########......####################-
####################################-
####################################-
####################################-
####################################-
####################################-
####################################-
####################################