####################################-
####################################-
####################################-
####################################-
####################################-
####################################-
####################################-
####################################-
####################################-
####################################-
####################################-
####################################-
####################################-
####################################-
####################################-
####################################-
####################################-
####################################-
####################################-
####################################-
####################################-
####################################-
####################################-
####################################--
####################################-
####################################-
####################################-
####################################-
####################################-
####################################-
####################################-
####################################-
####################################-
####################################-
###############.......##############-
###############.#####.##############-
###############.#####.##############-
###############.#####.##############-
##########...##.#####.##############-
##########.O...B......##############-
##########...##.####################-
###############.####################-
###############.####################-
###############.####################-
###############.####################-
###############.####################-
###############.####################-
###############.####################-
###############.####################-
###############.####################-
###############.####################-
######.....####.####################-
######..I.......####################-
######.....#########################-
####################################-
####################################-
####################################-
####################################-
####################################-
####################################-
####################################-
####################################-
####################################-
####################################-
####################################